name	имя
name	называть, назначать
narrow	узкий
national	национальный, народный
natural	естественный, природный
naturally	естественно
nature	природа
near	близко, около, возле, рядом
near	ближний, близкий
nearly	почти
neat	аккуратный
necessary	необходимый, нужный
neck	шея, воротник, горлышко
need	нуждаться, требоваться
needle	игла
negative	отрицательный, негативный
neither	ни тот ни другой, ни один из двух
neither	также не
nerve	нерв, мускул
nervous	нервный
never	никогда
new	новый
news	известие, новость
next	следующий, потом, рядом
nice	хороший, приятный
night	ночь
no	не, нисколько не
no	никакой, нет
noise	шум, грохот
noisy	шумный, неспокойный
none	никакой, ни один, никто
nonsense	абсурд, ерунда
no one	никто
nor	и... не, также... не
normal	нормальный, обыкновенный
nose	нос
not	не, нет, ни
note	записка, нота
nothing	ничего, ничто
notice	объявление, афиша
now	сейчас
now	теперь
nowhere	нигде, никуда
number	число, номер, количество
nurse	медицинская сестра